NO                ./asset/vanilla_tiles/xpm/north_wall.xpm
SO                ./asset/vanilla_tiles/xpm/south_wall.xpm
WE                ./asset/vanilla_tiles/xpm/west_wall.xpm
EA                ./asset/vanilla_tiles/xpm/east_wall.xpm


F 32,32,32
C 16,16,16

11111111111111111111
10000000000000000001
10000000000000000001
100000000N0000000001
11110111111111011111
   101       101
11110111111111011111
10000000010000000001
10010100010001010001
10000000010000000001
10010100010001010001
10000000000000000001
11111111111111111111
