NO                ./asset/texture/xpm_files/env_textures/north_wall.xpm
SO                ./asset/texture/xpm_files/env_textures/south_wall.xpm
WE                ./asset/texture/xpm_files/env_textures/west_wall.xpm
EA                ./asset/texture/xpm_files/env_textures/east_wall.xpm

F 220,100,0
C 0,128,0
                     111111111111111111111111111111
                     100000000000000000000000000001
                     100000000000000000000000000001
   111111111111111111100111111111111111111111111001
   1000000000000000000001                      1001
   100000000N000111111001        111111111111111001111111
11110000000000001    1001        100000000000000000000001
10000000000000001    1001        10000000011111101111110111
10000000000000001111110011111111110000000011111101111110001
10000000000000000000000000000000000000000000000000000000111
11111111111111111111111111011111111111111111111101111110111
101                      101                   101    10001
10111111111111111111111111011111111111111111111101111110111
100000000000000000000000000000000000000000000000000000001
111111111100111111111111111111111111111111111111111111111
         100100000000000000000000010000000000001000000001
         100000000000000000100000010000001000001000000001
         100100000000000000100000000000001000000000000001
         111111111111111111111111111111111111111111111111
