NO                ./asset/vanilla_tiles/xpm/north_wall.xpm
SO                ./asset/vanilla_tiles/xpm/south_wall.xpm
WE                ./asset/vanilla_tiles/xpm/west_wall.xpm
EA                ./asset/vanilla_tiles/xpm/east_wall.xpm


F 32,32,32
C 16,16,16


11111111111111111111
10000000000000000001
10101101110000000001
10101000010000000001
10101000011011011011
11101111110000000001
10000000010000000001
10011111010000000001
10010000010000000001
11110011111111101111
10010010010001000001
10010010010000000001
10000000010001000001
10010010011111000001
1DD1DD1DD10001000001
10000000010000000001
10000010010001000001
1000N000011011000001
10000000010001000001
11111111111111111111
