NO                ./asset/vanilla_tiles/xpm/north_wall.xpm
SO                ./asset/vanilla_tiles/xpm/south_wall.xpm
WE                ./asset/vanilla_tiles/xpm/west_wall.xpm
EA                ./asset/vanilla_tiles/xpm/east_wall.xpm


F 32,32,32
C 16,16,16

11111111111111111111    111
100000010000010000011111101        111111111111
100010010010010010000000001        100000R00001
100010000010000010011111101        100000000001   1111111
111C1111111111111111111110111111111111111C111111111000001
1000000000000000000C000000000000000C00000000000000000R001
10000000000000000001111110111111111111111111111C111000001
11111100000000000001    101                   101 1000001
10000101100110011001    101                   101 1111111
10E00C00000000000001 1111C111111111111111     101
10000101100110011001 10000000000000000001     101
11111100000000000001 1000000000000000000111111101
10000000000000000001 1000000000R00000000C00000001
10000000000000000001 1000000000000000000111111111
10000000000000000001 10000000000000000001
10000000000000000001 111111111C1111111111
11001111111111110011         101
10000000000000000001 11111111101111111111
10000000000000000001 1000R00000000000000111111111
11111111C11111111111 10000000000000000000000000M1
       101           1111111110111111111111111111
       101                   101
       10111111111111111111111C1
       1000000000000000000000001
       1111111111111111111111111
