NO                ./asset/vanilla_tiles/xpm/north_wall.xpm
SO                ./asset/vanilla_tiles/xpm/south_wall.xpm
WE                ./asset/vanilla_tiles/xpm/east_wall.xpm
EA                ./asset/vanilla_tiles/xpm/west_wall.xpm

F 220,100,0
C 0,128,0

11111111111111111111111111111111111111111111111111111111111111111111111111111111
10000000000000000000000000000000000000000000000000000000000000000000000000000001
1000000000000000000000000000000N000000000000000000000000000000000000001111111111
110111D1111111111111111111111111111111111111111111111111111111111111001
10010000000000000000000000000000000000000000000000000000000000000001001
10010000000000000000000000000000000000000000000000000000000000000001001
10110011111111111111111111111111111111D11111111111111111111111111111001
10010010000000000100000000000000000000000000000000000000000000001001001
10010010000000000000000100000000000000000000000000000000100000001001001
110100100111111111111111111111111111111111111111111111111D111111100D001
100100D0010000000000000100000000000000000000000000000000000001001001001
10010010010000000000000D00000000000000000000000000000000000001001001001
10110010010000000000000100000000000000000000000000000000000001001001001
10010011111111111111111111111111111111111111111111111111111111001001001
10010010000100000100000100000100100000000000000000000000000000001001001
11010010000000100000100000100000100000000000000000000000000000001001001
100100111D1111111111111111111111111111111111111111111111111111111001001
1001000000000000000000000000000000000000000000000000000000000000D001001
10110000000000000000000000000000000000000000000000000000000000001001001
10011D11111111111111111111111111111111111111111111111111111111111111001
10000010010000010000010000010010000000000000000000000000000000000000001
100100D0000100000100000100000100000000000000000000000000000000000000001
11111111111111111111111111111111111111111111111111111111111111111111111
