NO                ./asset/vanilla_tiles/xpm/north_wall.xpm
SO                ./asset/vanilla_tiles/xpm/south_wall.xpm
WE                ./asset/vanilla_tiles/xpm/east_wall.xpm
EA                ./asset/vanilla_tiles/xpm/west_wall.xpm

F 220,100,0
C 225,30,0

1111111111111111111111111
1000000000000000000000001
1000000000000000000000001
1000000000001110000000001
1000000000000000000000001
1000000000000000000000001
1000000000000000000000001
1000000000000000000000001
1000000000N00000010000001
1000000000000000010000001
1000000000000000010000001
1111111111111111111111111
