NO ./asset/texture/xpm_files/env_textures/north_wall.xpm
SO ./asset/texture/xpm_files/env_textures/south_wall.xpm
WE ./asset/texture/xpm_files/env_textures/west_wall.xpm
EA ./asset/texture/xpm_files/env_textures/east_wall.xpm

F 220,100
C 225,30,-99999999999999

   1111111111111111111111
   1000000000000000000001
   100000000N000111111001        111111111111111111111111
11110000000000001    1001        100000000000000000000001
10000000000000001    1001        100000000111111111111101
1000000000000000111111001111111111000000001           101
1000000000000000000000000000000000000000001           101
1111111111111111111111111101111111111111111           101
101                      101                          101
101111111111111111111111110111111111111111111111111111101
100000000000000000000000000000000000000000000000000000001
111111111111111111111111111111111111111111111111111111111
